1111111111111111111111111111111111111111111111111111111111111111111111111111111111111111111111111111
1111111111111111111111111111111111111111111111111111111111111111111111111111111111111111111111111111
1111111111111111111111111111111111111111111111111111111111111111333333333111111111111111111111111111
1113333333333333311111111111111111111111111111111111111111111113.........311111111111111111111111111
113..............31111111111111111111111111111111111111111111113.........311111111111111111111111111
113..............31111111111111111111111111111111111111111111113..333....311111111111111111111111111
113..333.........31111111111111111111111111111111111111111111113.........311111111111111111111111111
113..............31111111111111111111111111111111111111111111113......33.311111111111111111111111111
113......333.....31111111111111111111111111111111111111111111113.........311111111111111111111111111
113..............33333333333333333333333333333333333333333333333.33......333333333333333333311111111
113.333.....................................................................................31111111
113.........................................................................................31111111
113..............33333333..3333333333333333333333333333333333333333..33333333333333.........31111111
113..............311113..........3111111111111111111111111111111113..31111111111113..MMM....31111111
113.....333......311113..........3111111111111111111111111111111113..31111111111113..333....31111111
113.....3........311113....3.....3111111111111111111111111333333333..31111111111113.........31111111
113.....3........311113......MMM.3333333333333333333333333...........33333333333333....X.3..31111111
113.....3........311113...........................................................3.MMM.....31111111
11133333133333333111113...........................................................3.33......31111111
11111111111111111111113.3........3333333333333333333333333......MMM..333....3.....3.........31111111
11111111111111111111113..........3111111111111111111111113....................MMM.......33..31111111
11111111111111111111113......333.3111111111133333333333333..............................33..31111111
11111111111111111111113..........31111111113.............3.333.......333................33..31111111
1111111111111111111111133....333311111111113.............3...........313.3........33333333..33333311
1111111111111111111111113....311111111111113..333........3......333..313..........313.............31
1111111111111111111133333....333111111111113.............3...........313......333.313.............31
11111111111111111113............311111111113......333....33333..333..313..........313..333........31
11133333333331111113............311111111113....................313..31133....3333113.............31
113..........3333333..333.......333333333333.333................333..33333....3333333.......33....31
113...............................................................................................31
113..33...........................................................................................31
113......MMM.3333333..............................................................333.............31
113...............................................................................313.............31
113.........................................................................3.....313.............31
113.333......3333333............333333333333.............33333333333..............313.............31
113..........3111113............31111111113333333.................................313...33...33...31
113.....3333.3111113.....33..3..3111111113........................................313.............31
113..........3111113............3111111113..........3333333333333333..............311333333333333311
111333333333311111113333333..3331111111113..333.....3111111111111113..............311111111111111111
111111111111111111111111113..3333333333333......MMM.3111111111111113.....333......311111111111111111
111111111111111111111111113.....................333.3111111111111113.....3........311111111111111111
111111111111111111111111113....................P....3111111111111113.....3........311111111111111111
111111111111111111111111111333333333333333.333......3111111111111113.....3........311111111111111111
111111111111111111111111111111111111111113..........311111111111111133333133333333111111111111111111
111111111111111111111111111111111111111113.....3333.311111111111111111111111111111111111111111111111
111111111111111111111111111111111111111113..........311111111111111111111111111111111111111111111111
1111111111111111111111111111111111111111113333333333111111111111111111111111111111111111111111111111
1111111111111111111111111111111111111111111111111111111111111111111111111111111111111111111111111111
1111111111111111111111111111111111111111111111111111111111111111111111111111111111111111111111111111
1111111111111111111111111111111111111111111111111111111111111111111111111111111111111111111111111111
