..............
..............
..111.........
..............
......111.....
..............
.111..........
..............
..............
..............
.....111......
.....1........
.....1........
.....1........