.............
.............
..111........
.............
......111....
.............
.111.........
.............
.............
.............
.............
...11...11...
.............