............
............
..111.......
............
......111...
............
.111........
............
.......1....
.......1....
.....11111..
............