..........
..........
..111.....
......MMM.
......111.
..........
.111......
..........
.....1111.
..........