...............
...............
..111..........
...............
......111......
...............
.111...........
...............
.......1111....
...............
.1111..........
...............
...............
......111......
...............