........
..MMM...
..111...
........
......11
.MMM....
.111....
........