.........
.........
..111....
.........
......11.
.........
.111.....
.........
.........